1111111111111111111111111111111111111111
1000000000000000000000000000000000000001
1000000000000000000000000000000000000001
1000000000000000000000000000000000000001
1000011111111100000000000011111111100001
1000011111111100000000000011111111100001
1000011111111100000000000011111111100001
1000000011000000000000000000011000000001
1000000011000000000000000000011000000001
1000000011000000000000000000011000000001
1000000011000000000000000000011000000001
1000000000000000000000000000000000000001
1000000000000000000000000000000000000001
1000000000000000000000000000000000000001
1010000000000000000000000000000000000001
1010000000000000000000000000000000000001
1010000000000100000000001000000000000001
1010000000000100000000001000000000000001
1010000000000111111111111000000000000001
1000000000000000000000000000000000000001
1000000000000000000000000000000000000001
1000000000000000011100000000000000000001
1000000000000000001000000000000000000001
1000000000000000000000000000000000000001
1000000000000000000000000000000000000001
100000000P000000000000000000000000000001
1000001111111111100000000000000011111111
1000001111111111100000000000000011111111
1011000000000000000000000000000000000001
1111111111111111111111111111111111111111
