000000000000000000000000000000
000000000000000000000000000000
000000000000000000000000000000
000011111111110001111111111000
000000000000010001000000000000
000000000000010001000000000000
000000000000010001000000000000
000000000000010001000000000000
000000000000010001000000000000
000000000000010001000000000000
000000000000010001000000000000
000000000000010001000000000000
000000000000010001000000000000
000000000000000000000000000000
000000000000000000000000000000
000000000000000000000000000000
0000000000P0000000000000000000
000000000000000000000000000000
000000000000000000000000000000
000011111110000011111100000000
000000000000000000000000000000
000000000001111100000000000000
000000000000000000000000000000
000000000000000000000000000000
000000000000000000000000000000
000000000000000000000000000000
000000000000000000000000000000
