000000000000000000000000000000
000000000000000000000000000000
000000000000000000000000000000
000000000000000000000000000000
000000000000000000000000000000
000211111111100001111111113000
000000000000100001000000000000
000000000000100001000000000000
000000000000100001000000000000
000000000000100001000000000000
000000000000100001000000000000
000000000000100001000000000000
000000000000100001000000000000
000000000000100001000000000000
000000000000100001000000000000
000000000000000000000000000000
000000000000000000000000000000
000000000000000000000000000000
000000000000000000000000000000
000000000000000000000000000000
000000000000000000000000000000
000000000000000000000000000000
000000211113000000211113000000
000000000000000000000000000000
000000000000000000000000000000
000000000000021130000000000000
000000000000000000000000000000
0000P0000000000000000000000000
000000000000000000000000000000
